****************###########****
*******************************
%***#########***********#%*****
************************###****
**************###**************
@******************************
#******************************
*****************************%*
*********######################
*******************************
****###*************%**********
********************###*******%
%****************************##
######************#####********
*******************************
*********##########************
**************%****************
***#***#***#**#***#**#***####**