*#**************####**%****#***
*#%*##***********#######***#***
*#####*************************
*********#################****#
*********#*****%***************
*********#**###########********
#********#**#*********#*%****##
#********#**#**#####**#*******#
#****#***#**#&***@*#**#*******#
#*%**#***#**##*****#**#****####
#****#***#**########**#***#****
#****#***#************#***#****
*********#******%*****#***#****
*********##############********
***************************%***
****#######***********######***
******%**##########************
***##########******************