*#**************####**%****#***
*#%*##***********#######***#***
*#####*************************
*********#################****#
*%*******#*********************
*********#**###########*****%**
#********#**#*********#******##
#********#**#**#####**#*******#
#****#***#**#****@*#**#*******#
#*%**#***#**##*****#**#****####
#****#***#**########**#***#****
#****#***#************#***#****
*********#******%*****#***#****
**&******##############********
***************************%***
****#######***********######***
******%**##########************
***##########******************