*#**************####**%****#****
*#%*##***********#######***#****
*#####**************************
*********#################****#*
*%*******#**********************
*********#**###########*****%***
#********#**#*********#******##*
#********#**#**#####**#*******#*
#****#***#**#****@*#**#*******#*
#*%**#***#**##*****#**#****####*
#****#***#**########**#***#*****
#****#***#************#***#*****
*********#******%*****#***#*****
**&******##############*********
***************************%****
****#######***********######****
******%**##########*************
***##########*******************