###############################
#..........##......###........#
#..####..&.##.....#####.....%.#
#..#%.#....##.................#
#..##.#..%.#######.....#####..#
#.....#######...........##....#
#....#............%.....##....#
#...##......#.....###.........#
#...#####...#..@..#..#.....##.#
#.%..#......#.....#..####..##.#
#.....#.....#######..#........#
#......#........#.............#
#.......#.......#....####%#...#
#...............#....#........#
#######.........#.............#
#.........#############...##..#
#%.##.........####........%...#
###############################