###############################
#..........##......###........#
#..####....##.....#####.....%.#
#..#%.#....##.................#
#..##.#..%.#######.....#####..#
#.....#######...........##....#
#....#.........&..%.....##....#
#...##......#.....###.........#
#...#####...#..@..#..#.....##.#
#.%..#......#.....#..####..##.#
#.....#.....#######..#........#
#......#........#.............#
#.......#.......#....####%#...#
#...............#....#........#
#######.........#.............#
#.........#############...##..#
#%.##.........####........%...#
###############################