****************##########
###########*****#......@.#
#.........#*****#..#.....#
#..##.....#*****#%.......#
#.........#########....###
#####..####............#**
**#..........######....##*
**#..........#..........#*
**#%.........#.......%..#*
**###......###..........#*
**#........#*#.%........#*
**#........#*############*
**#........#**************
**########################
**************************