****************###########****
###########*****#......@..##***
#%........#*****#..#......##***
#..##.....#*****#%........##***
#.........#########......###***
#####..####..............#*****
**#...........######.....######
**#..........#..........###****
**#%.........#.......%....#****
#####......###............#****
**#..........#.#.%........#****
**#.%........##############****
**#..........#*****************
**###.........#############****
****####.................##****
*******##......##%##....##*****
***#####......#######....######
******#########*****#######****